1111111111111111
1000000000000001
10000100000C0001
10001P1000000001
100001E000000001
1000000000000001
1000C00000000001
10000000000C0001
1000000000000001
1111111111111111